0 0 0 0 0 4 2 4 2 4 2 4 0 0 0 0
0 0 0 0 0 3 1 3 1 3 1 3 0 0 0 0
0 0 0 0 0 4 2 4 2 0 2 4 2 4 0 0
0 0 0 0 0 3 1 3 1 3 1 3 0 0 0 0
0 0 0 0 0 4 2 4 2 4 2 4 2 4 2 4
0 0 0 0 0 3 1 3 1 3 1 3 1 3 1 3
0 0 0 0 0 2 2 0 0 0 2 4 2 0 2 4
0 0 0 0 0 2 2 0 1 0 1 3 1 3 1 3
0 0 0 0 0 1 1 1 0 0 2 4 2 4 2 4
0 0 0 0 0 1 1 1 3 3 1 3 1 3 1 3
1 1 1 1 1 1 1 1 3 3 1 3 1 3 1 3
1 1 1 1 1 1 0 0 0 0 0 0 0 0 0 0
1 1 1 1 1 1 0 0 0 0 0 0 0 0 0 0
1 1 8 1 1 1 0 0 0 0 0 0 0 0 0 0
1 1 1 1 1 1 0 0 0 0 0 0 0 0 0 0
1 1 1 1 1 1 0 0 0 0 0 0 0 0 0 0
